555555555555
558888885555
560000004555
560000007888
560013000000
560046000000
560045222222
560045555555
552255555555
555555555555

