5555555555555
5558888885555
5560000004555
8890000007888
0000000000000
0000000000000
2230000001222
5560000004555
5552222225555
5555555555555