5555555555555
8888888885555
0000000004555
0000000004555
2230000004555
5560000007888
5560000000000
5560000000000
5552222222222
5555555555555