555555555555
888888885555
000000004555
000000007888
223000000000
556000000000
555222222222
555555555555