5555555555555
5558888885555
5560000004555
5560000007888
5560013000000
5560046000000
5560045222222
5560045555555
5552255555555
5555555555555