5588888855
5600000045
5600000045
5600130045
5600790045
5600000045
5600000045
5522222255

