555555555555
555888888555
556000000455
556000000455
556000000455
889000000455
000000000455
000000000455
222222222555
555555555555